10 10
.f........
...f..f...
..........
..........
..........
.......f..
..........
........h.
..........
s.........
